1111111111
100E000001
1000000001
100C000001
1000000001
1P00000001
1111111111
