1111111111
101E000001
1011100001
101C100001
1010101111
1PC00000C1
1111111111
