111111111111111
1E0000000C00001
111111111111101
10C0000000C0001
101111111111111
100C0000C000C01
111111111111101
10C0000C0000001
101111111111111
1C000C00P0000C1
111111111111111
